....................
....................
....................
....................
....................
....................
....................
.........111........
.........###........
....................
....111.......111...
....###.......###...
....................
.P................X.
####################
