....................
....................
....................
....................
....................
....................
....................
....................
.........###........
....................
.....1.........2....
....#;#.......###...
....................
........P.......X...
####################
