....................
....................
....................
....................
....................
....................
....................
....................
.........###........
....................
....................
....###.......###...
....................
.P................X.
####################
