....................
....................
....................
....................
...............2....
..............###...
....................
....................
.........###........
....................
.....1..............
....#;#.............
....................
........P.......X...
####################
