....................
....................
............X.......
......########......
..2.................
####............####
....................
....................
.......------.......
...--...........--..
.1................1.
#;##............####
....................
.P..................
####################
