....................
....................
....................
.....##########.....
....................
####............####
....................
......--------......
...--...........--..
....................
.1................1.
####............####
.P..............X...
####################
