....................
P...................
......########......
....##........##....
..##............--..
.#...2..............
.#...#....X.........
.#........#######-..
#.##..........##...#
....##1....A##....#.
......###;###....#..
................#...
....................
....................
####################
