....................
....................
......2.............
.....##########.....
..1............1....
####............####
....................
......--------......
...--...........--..
....................
.1..............1...
####............####
.P.....X............
####################
