....................
......P.....A3......
.....#########......
....#.........#2....
...#.....3.....#1...
..#.....---.....#...
..#..B......C...#...
#.#######;#######..#
..#.............#...
..#.............#...
.-#........X....#-..
.......#####........
#.................##
....B........A......
####################
