....................
....................
......2......A......
.....##########.....
..1............1....
####............####
....................
......--------......
...--...........--..
....................
.1..............1...
####............####
.P..............X...
####################
