....................
.........X..........
......2......B......
.....##########.....
..1....A.........1..
####............####
....................
......--------......
...--...........--..
....................
.1.1............1.1.
####............####
.P..................
####################
