....................
#..................#
...##1........1##...
...###2......2###...
..#####3....3#####..
...##.##....##.##...
...##..#3.DX#..##...
#..##...####...##..#
P..##..........##...
...##..........##...
..###....121...###..
........####........
....................
........A.......B...
####################
