....................
........12221.......
#..##############...
...##...............
...##...............
P..##A..B..3.C..D...
..###############...
...##...............
...##...............
...##.1..1..1..1....
#..##############...
...................X
...................#
....B.........C.....
#########.##########
