....................
.........X..........
......3...A.....3...
.....##########.....
..1..............1..
####..2..B..2....###
....................
......--------......
...--...........--..
....................
.1.1............1.1.
####............####
.P..................
####################
