....................
.........X..........
......D..33..B......
.....##########.....
..1..............1..
####..2.2.2.2....###
.......2.2.2C2......
......--------......
...--...........--..
....................
.1.1............1.1.
####............####
....................
.P..................
####################
