########
....--..
....G.X.
G...----
-...G..B
..------
.G....G.
##......
...G....
...--...
......G.
......##
G.G.....
####....
.......G
.....---
........
..##....
1G..GGGG
########
