........
........
.X......
--......
........
..G.G.GC
..######
........
........
--......
........
..G.G.GC
..######
........
1.......
########
