........
..GGG...
##---##.
..--..#.
...D..#.
------#.
GG....#.
.----.#.
...G..#.
...-..#.
..G...#.
..-...#.
...--.#.
.--...#.
GGG...#.
---.-.#.
......#.
....-.#.
1.GG..#X
########
