.....G..
.....#..
.---.#..
.G...#X.
.--..###
...GG...
...--...
.....G..
#...---.
#####..#
#......#
#..GG..#
#..#####
#......#
#.GG...#
#####..#
.......#
....G..#
1.######
########
